哀	āi * sorrow / grief / pity
求	qiú * to seek / to look for / to request
艾	ài * (surname) / Artemisia vulgaris / Chinese mugwort
滋	zī * excite / nourish / this
病	bìng * ailment / sickness / illness
爱	ài * to love / affection / to be fond of
戴	dài * to put on / to respect / to bear
面	miàn * flour / noodles / side / surface
子	zǐ * 11 p.m.-1 a.m. / 1st earthly branch / child
惜	xī * pity, regret, rue, begrudge
碍	ài * to hinder / to obstruct / to block
事	shì * matter / thing / item
安	ān * content / calm / still
宁	níng * peaceful / rather / Ningxia (abbrev.)
稳	wěn * settled / steady / stable
详	xiáng * detailed / comprehensive
置	zhì * to install / to place / to put
按	àn * to press (with the hand) / to push / to control
劳	láo * toil
分	fēn * to divide / minute / (a measure word)
配	pèi * to join / to fit / to mate
暗	àn * dark / gloomy / hidden
淡	dàn * insipid / diluted / weak
杀	shā * to kill / to murder / to slaughter
示	shì * to show / reveal
中	zhōng * within / among / in
案	àn * (legal) case / incident / record
件	jiàn * a measure word for thing, clothes, item
情	qíng * feeling / emotion / passion
昂	áng * high / raise (head)
贵	guì * expensive / noble / your (name)
扬	yáng * hurl / to raise / to scatter
凹	āo * a depression / indentation / concave
袄	ǎo * coat / jacket / short and lined coat or robe
舞	wǔ * to dance / to wield / to brandish
捌	bā * complicated form of the numeral eight / split
疤	bā * scar
巴	bā * (suff. for certain nouns) / to hope / to wish
结	jié * knot / to bear (fruit) / to tie
把	bǎ * (a measure word) / (marker for direct-object) / to hold
柄	bǐng * authority / handle / hilt
关	guān * (surname) / mountain pass / to close
手	shǒu * hand / convenient
戏	xì * trick / drama / play
霸	bà * feudal chief / rule by force / tyrant
道	dào * direction / way / method
权	quán * authority / power / right
占	zhàn * to occupy / to constitute / to make up
掰	bāi * to break with both hands
白	bái * white / snowy / empty
酒	jiǔ * wine / liquor / spirits
百	bǎi * hundred
倍	bèi * (two, three, etc) -fold / times (multiplier) / double
比	bǐ * (particle used for comparison and "-er than") / to compare / to contrast
花	huā * flower / blossom / to spend (money, time)
齐	qí * (surname) / even / to make even
放	fàng * to release / to free / to let go
家	jiā * furniture / tool / -ist
争	zhēng * struggle / fight
鸣	míng * to cry (of birds)
摆	bǎi * pendulum / to place / to display
动	dòng * to use / to act / to move
败	bài * be defeated / to defeat / loss
坏	huài * bad / evil / rotten
拜	bài * to pay respect / worship / visit
年	nián * year
斑	bān * variegated
班	bān * team / class / rank
机	jī * machine / opportunity / secret
搬	bān * remove / transport / move
运	yùn * to move / to transport / to use
扳	bān * to pull or draw (up or out)
布	bù * to declare / to announce / to spread
发	fā * to send out / to show (one's feeling) / to issue
版	bǎn * a register / a block of printing / an edition
扮	bàn * to disguise oneself / to dress up / adorn
演	yǎn * to develop / to evolve / to practice
拌	bàn * to mix / mix in / to toss (a salad)
伴	bàn * a partner / companion or associate / to accompany
随	suí * to follow / to comply with / to allow
奏	zòu * present a memorial
半	bàn * half / semi- / incomplete
边	biān * side / edge / margin
天	tiān * day / sky / heaven
截	jié * a section / cut off (a length)
径	jìng * path
路	lù * (surname) / road / path
数	shù * number / figure / to count
途	tú * way / route / road
而	ér * and / as well as / but (not)
废	fèi * abolish / crippled
真	zhēn * real / true / genuine
假	jià * vacation
办	bàn * to do / to manage / to handle
学	xué * learn / study / science
绑	bǎng * to tie / bind or fasten together
架	jià * to support / frame / rack
棒	bàng * a stick / club or cudgel / smart
球	qiú * ball / sphere
包	bāo * to cover / to wrap / to hold
干	gàn * main part of something / to manage / to work
儿	ér * son
裹	guǒ * wrap around
装	zhuāng * adornment / adorn / costume
保	bǎo * to defend / to protect / to insure or guarantee
健	jiàn * healthy
姆	mǔ * governess
温	wēn * (luke)warm / to review
养	yǎng * give birth / keep (pets) / to support
重	zhòng * heavy / serious
堡	bǎo * an earthwork / castle / position of defense
垒	lěi * rampart
饱	bǎo * to eat till full / satisfied
和	hé * and / together with / with
满	mǎn * Manchurian / to fill / to fulfill
宝	bǎo * a jewel or gem / a treasure / precious
贝	bèi * cowries / shell / valuables
剑	jiàn * (double-edged) sword
库	kù * warehouse / storehouse
抱	bào * to hold / to carry (in one's arms) / to hug or embrace
负	fù * lose / negative (math. etc.) / to bear
怨	yuàn * blame / complain
报	bào * to announce / to inform / report
答	dá * reply / answer / return
考	kǎo * to check / to verify / to test
销	xiāo * to melt / to do away with / to sell
暴	bào * sudden / violent / cruel
风	fēng * wind / news / style
雨	yǔ * rain
力	lì * power / force / strength
爆	bào * to crack / to explode or burst
破	pò * to break / to split / broken
竹	zhú * bamboo
悲	bēi * sad / sadness / sorrow
惨	cǎn * miserable / wretched / cruel
愤	fèn * indignant / anger / resentment
剧	jù * drama / play / show
伤	shāng * injure / injury / wound
背	bēi * to be burdened / to carry on the back or shoulder
叛	pàn * to betray / to rebel / to revolt
壳	ké * shell
备	bèi * to prepare / get ready / to provide or equip
用	yòng * to use
被	bèi * by (marker for passive-voice sentences or clauses) / quilt / blanket
告	gào * to tell / to inform / to say
奔	bēn * to hurry or rush / to run quickly / to elope
腾	téng * to soar / to gallop / to rise
本	běn * roots or stems of plants / origin / source
能	néng * can / may / capable
钱	qián * (surname) / coin / money
性	xìng * sex / nature / surname
着	zhe * particle attached after verb to indicate action in progress, like -ing ending
笨	bèn * stupid / foolish / silly
蛋	dàn * egg / oval shaped
溃	kuì * be dispersed / break down
绷	bēng * to stretch / taut / to tie
带	dài * band / belt / girdle
蹦	bèng * to jump / bounce or hop
逼	bī * force / compel / drive
近	jìn * near / close (to) / approximately
迫	pò * to force / to compel / pressing
鼻	bí * nose
价	jià * price / value / valence (on an atom)
笔	bǐ * pen / pencil / writing brush
迹	jī * footprint / mark / trace
直	zhí * straight / vertical / frank
彼	bǐ * that / those / (one) another)
绿	lǜ * green
币	bì * money / coins / currency
闭	bì * to close / stop up / shut
幕	mù * stage curtain / tent
式	shì * type / form / pattern
塞	sāi * stop up / to squeeze in / to stuff
端	duān * end / extremity / item
必	bì * certainly / must / will
将	jiāng * (will, shall, "future tense") / ready / prepared
避	bì * avoid / shun / flee
策	cè * method / plan / policy
炮	pào * cannon / gun / firecracker
防	fáng * to protect / to defend / to guard (against)
境	jìng * border / place / condition
编	biān * weave / plait / organize
号	hào * day of a month / (suffix used after) name of a ship / (ordinal) number
者	zhě * -ist, -er (person) / person (who does sth)
低	dī * to lower (one's head) / to let droop / to hang down
义	yì * justice / righteousness / meaning
值	zhí * value / (to be) worth / to happen
便	biàn * ordinary / plain / convenient
变	biàn * to change / to become different / to transform
更	gèng * more / even more / further
换	huàn * change / exchange
迁	qiān * to move / to shift
形	xíng * to appear / to look / form
质	zhì * hostage / substance / nature
辩	biàn * dispute / debate / argue
别	bié * leave / depart / separate
认	rèn * to recognize / to know / to admit
护	hù * protect
解	jiě * to separate / to divide / to break up
证	zhèng * certificate / proof / to prove
法	fǎ * law / method / way
遍	biàn * a time / everywhere / turn
地	dì * earth / ground / field
标	biāo * the topmost branches of a tree / surface / sign
题	tí * topic / subject / to inscribe
表	biǎo * surface / exterior / to watch
憋	biē * hold in (urine) / to hold (breath) / to choke
扭	niǔ * to turn / to twist / to grab
冰	bīng * ice
淋	lìn * diseases of the bladder / to drain / to drip
虫	chóng * insect / worm
害	hài * to do harm to / to cause trouble to / harm
毒	dú * poison / narcotics
并	bìng * and / also / together with / combine
存	cún * exist / deposit / store
非	fēi * non- / not- / un-
列	liè * to arrange / to line up / row
排	pái * a platoon / line up
播	bō * sow / scatter / spread
音	yīn * sound / noise / news
种	zhǒng * kind / type / race
拨	bō * to push aside / to appropriate (money) / to move
款	kuǎn * section / paragraph / funds
波	bō * wave / ripple / storm
博	bó * extensive / ample / rich
览	lǎn * look over / to view
会	huì * be able to / be likely to / to assemble
薄	bó * mean / slight / thin
膜	mó * (n) membrane; film
斗	dòu * to fight / to battle / to struggle
斥	chì * blame / reprove / reprimand
捕	bǔ * to catch / to seize / to capture
捞	lāo * fish up
捉	zhuō * to clutch / to grab / to capture
补	bǔ * to repair / to patch / to mend
偿	cháng * to compensate / pay back / to recompense
救	jiù * to save / to assist / to rescue
贴	tiē * to stick / to paste / to keep close to
助	zhù * to help / to assist
卜	bo * turnip
不	bù * (negative prefix) / not / no
辞	cí * bid farewell / diction / resign
当	dāng * to be / to act as / to hold a position (in space, time, or organizational space)
得	de * a sentence particle used after a verb to show effect / degree or possibility
已	yǐ * already / to stop / then
等	děng * class / rank / grade
定	dìng * to set / to fix / to determine
妨	fáng * hinder / harm
公	gōng * just / honorable (designation) / public
堪	kān * endure
良	liáng * good / very / very much
容	róng * to hold / to contain / to allow
时	shí * o'clock / time / when
相	xiāng * each other / one another / mutually
上	shàng * on / up / on top
下	xià * under / second (of two parts) / next (week, etc.)
言	yán * to speak / to say / talk
宜	yí * proper / should / suitable
正	zhèng * just (right) / main / upright
之	zhī * (literary equivalent of 的) / (subor. part.) / him
知	zhī * to know / to be aware
觉	jiào * a nap / a sleep
至	zhì * arrive / most / to
于	yú * in / at / to
局	jú * (a measure word used for games) set or round office / situation / office
步	bù * a step / a pace / walk
兵	bīng * soldiers / a force / an army
伐	fá * (v) cut down; fell / (v) dispatch an expedition against; descend upon
行	xíng * all right / capable / competent
埠	bù * a jetty / port / a city
部	bù * ministry / department / section
位	wèi * position / location / (measure word for persons)
猜	cāi * to guess
测	cè * side / to lean / to survey
裁	cái * cut out (as a dress) / cut / trim
决	jué * breach (a dyke) / to decide / to determine
军	jūn * army / military / arms
才	cái * ability / talent / just now
智	zhì * wisdom / knowledge
财	cái * money / wealth / riches
经	jīng * classics / sacred book / pass through
务	wù * affair / business / matter
采	cǎi * to pick / to pluck / to collect
访	fǎng * inquire / seek / visit
集	jí * to gather / to collect / collected works
纳	nà * to accept / to pay (tax etc.)
菜	cài * dish (type of food) / vegetables
单	dān * bill / list / form
餐	cān * eat / meal
参	cān * take part in / participate / join
议	yì * criticize / discuss
院	yuàn * courtyard / institution
与	yǔ * and / to give / together with
阅	yuè * peruse / review / to read
照	zhào * according to / in accordance with / to shine
残	cán * destroy / spoil / ruin
疾	jí * sickness / disease / hate
忍	rěn * to beat / to endure / to tolerate
余	yú * extra / surplus / remaining
仓	cāng * barn / granary / storehouse
促	cù * to hurry / to rush / to hasten
操	cāo * to hold / to drill / to exercise
练	liàn * to practice / to train / to perfect (one's skill)
槽	cáo * manger / trough / groove
草	cǎo * grass / straw / draft (of a document)
率	lǜ * rate / frequency
划	huà * to delimit / to transfer / to assign
略	lüè * plan / strategy / outline
侧	cè * the side / to incline towards / to lean
算	suàn * regard as / to figure / to calculate
层	céng * a measure word for layers / laminated / repeated
出	chū * to go out / to come out / to occur
穷	qióng * exhausted / poor
次	cì * nth / number (of times) / order
蹭	cèng * rub against / walk slowly
插	chā * insert / stick in / pierce
嘴	zuǐ * mouth
叉	chā * fork / pitchfork / prong / cross
差	chà * differ from / short of / to lack
错	cuò * mistake / error / blunder
距	jù * at a distance of / distance / to be apart
异	yì * (interj.) / raise / to stop / unusual
查	chá * to research / to check / to investigate
处	chù * a place / location / spot
获	huò * to catch / to obtain / to capture
明	míng * clear / bright / to understand
那	nà * that / those
岔	chà * branch in a road / astray / diverge
柴	chái * (surname) / firewood
油	yóu * oil / sly
掺	chān * mix
搀	chān * assist by the arm / mix / support
蝉	chán * cicada
馋	chán * gluttonous / greedy
缠	chán * to bother / wind around / wrap round
产	chǎn * to reproduce / to produce / give birth
区	qū * area / region / district
业	yè * business / occupation / study
述	shù * to state / to tell / to narrate
颤	zhàn * to tremble / to shiver / to shake
昌	chāng * prosperous / flourish
盛	chéng * to hold / contain / to ladle
狂	kuáng * conceited / mad
尝	cháng * indicator of past tense / to taste / flavor
试	shì * to test / to try / experiment
常	cháng * always / ever / often
规	guī * compass / rule
见	jiàn * to see / to meet / to appear (to be sth)
长	cháng * length / long / forever
短	duǎn * lack / short
寿	shòu * (long) life
征	zhēng * attack / levy (troops or taxes) / journey
还	hái * also / in addition / more
厂	chǎng * cliff / slope / factory
房	fáng * house
商	shāng * commerce / consult
场	chǎng * a courtyard / open space / place
所	suǒ * actually / place
开	kāi * open / operate (vehicle) / start
谈	tán * to speak / to talk / to converse
通	tōng * go through / know well / to connect
倡	chàng * initiate / instigate / introduce
超	chāo * to exceed / overtake / surpass
级	jí * level / grade / rank
越	yuè * to exceed / to climb over / to surpass
朝	cháo * to face / towards / facing
代	dài * substitute / replace / generation
笑	xiào * laugh / smile
潮	cháo * tide / current / damp
流	liú * to flow / to spread / to circulate
吵	chǎo * to quarrel / to make a noise / noisy
闹	nào * make noise or disturbance
车	chē * car / a vehicle / machine
床	chuáng * bed / couch / (a measure word)
撤	chè * remove / take away / withdraw
退	tuì * retreat / to decline / to move back
沉	chén * submerge / immerse / sink
静	jìng * still / calm / quiet
闷	mèn * melancholy
痛	tòng * ache / pain / sorrow
陈	chén * arrange / exhibit / narrate
旧	jiù * old (opposite of new) / former
称	chēng * to call / to praise / to weigh
心	xīn * heart / mind
城	chéng * city walls / city / town
镇	zhèn * composed / small town / to suppress
成	chéng * finish / complete / accomplish
交	jiāo * to deliver / to turn over / to make friends
品	pǐn * conduct / grade / thing
人	rén * man / person / people
套	tào * to cover / covering / case
效	xiào * effect / efficacy / imitate
呈	chéng * to assume (a form) / to submit / to petition
现	xiàn * appear / present / now
乘	chéng * ride / mount / make use of
员	yuán * person / employee / member
惩	chéng * punish / discipline
罚	fá * to punish / to penalize
清	qīng * clear / distinct / complete
诚	chéng * honest / sincere / true
意	yì * idea / meaning / wish
承	chéng * to bear / to carry / to hold
受	shòu * to bear / to stand / to endure
秤	chèng * steelyard
持	chí * to grasp / to hold / support
续	xù * continue / replenish
池	chí * pond / reservoir
塘	táng * pond
迟	chí * late / delayed / slow
缓	huǎn * slow / sluggish / gradual
疑	yí * to doubt / to misbelieve / to suspect
齿	chǐ * tooth
轮	lún * wheel / gear / (by) turn
赤	chì * red / scarlet / bare
字	zì * letter / symbol / character
充	chōng * fill / satisfy / fulfill
冲	chōng * to rinse / to collide / to water
锋	fēng * point or edge of a tool
申	shēn * (surname) / 3-5 p.m. / 9th earthly branch
崇	chóng * high / dignified / lofty
敬	jìng * to respect / to venerate / to salute
抽	chōu * to draw out / to smoke (cigarettes) / to pump
空	kōng * air / sky / empty
密	mì * secret / confidential / close
筹	chóu * a tally / counter / ticket
建	jiàn * to establish / to found / to set up
丑	chǒu * 2nd Earthly Branch / clown / Chou (surname) / shameful
恶	è * evil
点	diǎn * (downwards-right convex character stroke) / o'clock / (a measure word)
名	míng * name / (measure word for persons) / place (e.g. among winners)
入	rù * to enter
色	sè * color / look / appearance
神	shén * God / unusual / mysterious
世	shì * life / age / generation
售	shòu * to sell
师	shī * a division (milit.) / teacher / master
锄	chú * a hoe / to hoe or dig / to weed
除	chú * remove / do away with / wipe out
此	cǐ * this / these
外	wài * outside / in addition / foreign
储	chǔ * savings / to save / to deposit
藏	cáng * to hide away / to conceal / to harbor
蓄	xù * to store
方	fāng * square / quadrilateral / direction
触	chù * knock against / touch / to feel
犯	fàn * to violate / to offend
川	chuān * river / creek / plain
息	xī * news / interest / breath
传	chuán * to pass on / to spread / to transmit
递	dì * to hand over / to pass / to give
授	shòu * to teach / to instruct / to award
送	sòng * to deliver / to carry / to give (as a present)
船	chuán * a boat / vessel / ship
只	zhī * (a measure word, for birds and some animals, etc.) / single / only
疮	chuāng * sore / skin ulcer
铺	pù * a bed / a store
创	chuàng * begin / initiate / inaugurate
吹	chuī * to blow / blast / puff
牛	niú * ox / cow / bull
捧	pěng * hold or offer with both hands
捶	chuí * beat with the fist / to hammer / to cudgel
锤	chuí * to hammer / weight of steel yard
春	chūn * spring (time) / gay / joyful
耕	gēng * to plow / to till
纯	chún * pure / simple / unmixed
粹	cuì * pure / unmixed / essence
蠢	chǔn * blunt / stupid / to wiggle (of worms)
磁	cí * magnetic / magnetism / porcelain
铁	tiě * iron
雌	cí * female
职	zhí * office / duty
慈	cí * compassionate / gentle / merciful
祥	xiáng * auspicious / propitious
词	cí * works / phrases / classical Chinese poem
句	jù * (a measure word, for sentences or lines of verse) / sentence
后	hòu * back / behind / rear
序	xù * order / sequence / preface
刺	cì * thorn / sting / prick
葱	cōng * scallion / green onion
匆	cōng * hurried / hasty
从	cóng * from / obey / observe
看	kàn * it depends / think / to see
来	lái * to come
头	tóu * head
未	wèi * 1-3 p.m. / 8th earthly branch / not yet
小	xiǎo * small / tiny / few
凑	còu * assemble / put together / press near
合	hé * Chinese musical note / fit / to join
巧	qiǎo * opportunely / coincidentally / as it happens
粗	cū * coarse / rough / thick
粮	liáng * provisions
鲁	lǔ * crass / place name
细	xì * fine / minutely / thin
脆	cuì * brittle / fragile / crisp
弱	ruò * weak / feeble / young
搭	dā * build (scaffolding) / take (boat, train) / hang
辨	biàn * distinguish / recognize
打	dǎ * beat / strike / break
猎	liè * hunting
大	dà * big / huge / large
臣	chén * statesman / vassal / courtier
多	duō * many / much / a lot of
无	wú * -less / not to have / no
私	sī * personal / private / selfish
锅	guō * pot / pan / boiler
饭	fàn * food / cuisine / cooked rice
理	lǐ * reason / logic / science
石	shí * rock / stone
指	zhǐ * finger / to point / to direct
气	qì * air / anger / gas
压	yā * to press / to push down / to keep under (control)
肆	sì * four (fraud-proof) / market
体	tǐ * body / form / style
同	tóng * like / same / similar
畏	wèi * to fear
厦	shà * tall building
有	yǒu * to have / there is / there are
可	kě * can / may / able to
为	wéi * act as / take...to be / to be
徒	tú * apprentice / disciple
劲	jìn * strength
贷	dài * lend on interest / borrow / loan
待	dài * wait / treat / deal with
工	gōng * work / worker / skill
慢	màn * slow
担	dān * to undertake / to carry / to shoulder
忧	yōu * worried
丹	dān * red / pellet / powder
元	yuán * (dynasty) / dollar / primary
胆	dǎn * the gall / the nerve / courage
量	liàng * capacity / quantity / amount
氮	dàn * nitrogen
季	jì * season / period
水	shuǐ * water / river
诞	dàn * birth / birthday / brag
弹	tán * impeach / to pluck a string / to play (a stringed musical instrument with fingers)
药	yào * medicine / drug / cure
选	xuǎn * to choose / to pick / to select
党	dǎng * party / association / club
章	zhāng * (surname) / chapter / seal
央	yāng * beg / center
档	dàng * cross-piece / official records / grade (of goods)
荡	dàng * a pond / pool / wash
刀	dāo * knife
捣	dǎo * pound / beat / hull
乱	luàn * in confusion / disorderly
倒	dǎo * to fall / to collapse / to topple
爷	yé * grandpa / etc. / old gentleman
导	dǎo * to transmit / to lead / to guide
航	háng * boat / ship / vessel
游	yóu * to walk / to tour / to roam
到	dào * to (a place) / until (a time) / up to
期	qī * a period of time / phase / stage
稻	dào * paddy / rice
念	niàn * to read aloud
盗	dào * steal / rob / plunder
失	shī * to lose / to miss / to fail
以	yǐ * to use / according to / so as to
罪	zuì * guilt / crime / fault
灯	dēng * lamp / light
泡	pāo * puffed / swollen
登	dēng * scale / climb / ascend
陆	lù * (surname) / shore / land
劣	liè * inferior
敌	dí * enemy / match
对	duì * couple / pair / to be opposite
视	shì * to look at / to regard / to inspect
的	de * (possessive, modifying, or descriptive particle) / of
确	què * authenticated / solid / firm
抵	dǐ * hold up / on the whole / push against
达	dá * attain / pass through / achieve
制	zhì * system / to make / to manufacture
帝	dì * emperor
国	guó * country / state / nation
主	zhǔ * to own / to host / master
增	zēng * to increase / to expand / to add
掂	diān * weigh in the hand
覆	fù * to cover / to overflow / to reply to a letter
火	huǒ * fire
燃	rán * burn / combustion
电	diàn * electric / electricity / electrical
源	yuán * root / source / origin
店	diàn * inn / shop / store
粉	fěn * dust / powder
殿	diàn * palace hall
刁	diāo * artful / wicked
叼	diāo * (v) hold sth in the mouth
雕	diāo * engrave / shrewd / golden eagle
塑	sù * to model (a figure) in clay
调	diào * mode (music) / to move (troops) / tune
度	dù * capacity / degree / standard
顶	dǐng * go against / most / peak
额	é * volume / amount / quantity
居	jū * reside
律	lǜ * law
向	xiàng * direction / part / side
订	dìng * to agree / to conclude / to draw up
购	gòu * to buy / to purchase
货	huò * goods / money / commodity
钉	dīng * nail
丢	diū * to lose / to put aside / to throw
东	dōng * east
西	xī * west
走	zǒu * to walk / to go / to move
冬	dōng * winter
瓜	guā * melon / claw / gourd
董	dǒng * (surname) / supervise / to direct
脉	mài * mountain range / pulse
态	tài * attitude
冻	dòng * to freeze
栋	dòng * roof beam
兜	dōu * pocket
志	zhì * sign / mark / to record
都	dōu * all / both (if two things are involved) / entirely (due to)each
市	shì * market / city
督	dū * supervise
独	dú * alone / independent / single
立	lì * set up / to stand
自	zì * from / self / oneself
堵	dǔ * stop up
赌	dǔ * bet / gamble
杜	dù * (surname) / fabricate / restrict
绝	jué * cut short / extinct / to disappear
镀	dù * -plated / to plate
渡	dù * to cross / to pass through / to ferry
口	kǒu * mouth / (a measure word)
暂	zàn * temporarily
断	duàn * absolutely / decidedly (in negative constructions) / break
岸	àn * bank / shore / beach
抗	kàng * to resist / to fight / to defy
联	lián * to ally / to unite / to join
应	yīng * ought
夺	duó * rob / snatch
躲	duǒ * avoid / get out of way / to hide
跺	duò * (v) stamp one's foot
落	luò * alight / to fall / to drop (behind)
讹	é * error / exhort / false
鄂	è * Hubei province (abbrev.)
恩	ēn * kind act (from above)
二	èr * two / 2
氧	yǎng * oxygen
化	huà * to make into / to change into / -ization
贰	èr * two (fraud-proof)
愁	chóu * worry about
奋	fèn * exert oneself
图	tú * diagram / to plan / picture
强	qiáng * strength / force / power
脾	pí * spleen
票	piào * bank note / ticket
起	qǐ * to rise / to raise / to get up
热	rè * heat / to heat up / fervent
炎	yán * flame / inflammation / -itis
光	guāng * light / ray / bright
官	guān * official / government / organ of body
庭	tíng * court / courtyard
斯	sī * (phonetic) / this
则	zé * (expresses contrast with a previous sentence or clause) / standard / norm
帆	fān * sail
番	fān * (measure word for acts) / deeds / foreign
繁	fán * complicated / many / in great numbers
华	huá * (abbreviation for) China / (surname) Hua / magnificent
忙	máng * busy
烦	fán * feel vexed / to bother
恼	nǎo * get mad
反	fǎn * wrong side out or up / anti-
感	gǎn * to feel / to move / to touch
革	gé * leather / remove
命	mìng * life / fate
攻	gōng * to attack / to accuse / to study
射	shè * radio- (chem.) / shoot
思	sī * to think / to consider
返	fǎn * to return (to)
回	huí * (a measure word for matters or actions) a time / to circle / to go back
卖	mài * to sell
范	fàn * pattern / model / example
浑	hún * muddy
碗	wǎn * bowl / cup
泛	fàn * float / general / vague
程	chéng * rule / order / regulations
租	zū * rent / taxes
线	xiàn * thread / string / wire
疫	yì * epidemic / plague
飞	fēi * to fly
肥	féi * loose-fitting / fat / fertile
沃	wò * fertile / rich
肺	fèi * lung
物	wù * thing / object / matter
寸	cùn * a unit of length / inch / thumb
队	duì * squadron / team / group
红	hóng * bonus / popular / red
类	lèi * kind / type / class
母	mǔ * female / mother
批	pī * to ascertain / (measure word for batches, lots) / to act on
芬	fēn * fragrant
芳	fāng * fragrant
坟	fén * a grave
墓	mù * tomb
末	mò * end / final stage / latter part
勇	yǒng * brave
战	zhàn * to fight / fight / war
恨	hèn * to hate
丰	fēng * buxom / good-looking / appearance and carriage of a person
封	fēng * to confer / to grant / to seal
蜂	fēng * bee / wasp
蜜	mì * honey
利	lì * advantage / benefit / profit
浪	làng * wave / breaker / unrestrained
趣	qù * interesting / to interest
沙	shā * granule / hoarse / raspy
尚	shàng * still / yet / to value
味	wèi * taste
险	xiǎn * danger (ous) / rugged
疯	fēng * insane / mad / wild
缝	fèng * crack / seam
奉	fèng * to receive (from superior) / to offer / to revere
献	xiàn * to offer
凤	fèng * phoenix
否	fǒu * to negate / to deny / not
夫	fū * husband / man
妇	fù * woman
伏	fú * conceal (ambush) / prostrate / submit
幅	fú * (measure word for textile or picture) / width / roll
符	fú * mark / sign / talisman
服	fú * clothes / dress / garment
浮	fú * to float
福	fú * good fortune / happiness / luck
抚	fǔ * to comfort / touch gently with hand
育	yù * nourish / to rear
辅	fǔ * to assist / to complement / auxiliary
腐	fǔ * decay / rotten
烂	làn * overcooked / rotten / soft
赴	fù * go towards / go to / attend (a banquet, etc.)
副	fù * secondary / auxiliary / deputy
作	zuò * to regard as / to take (somebody) for / to do
盖	gài * lid / top / cover
赋	fù * poetic essay / taxation / bestow on
予	yǔ * to give
复	fù * again / recover / reply to a letter
辟	pì * dispel / open up / refute
活	huó * to live / alive / living
兴	xìng * interest
付	fù * pay
腹	fù * abdomen / stomach / belly
富	fù * rich
附	fù * to add / to attach / to be close to
加	jiā * to add / plus
属	shǔ * belong to / category / be subordinate to
改	gǎi * to change / to alter / to transform
邪	xié * demonical / iniquitous / nefarious
归	guī * to go back / to return
组	zǔ * to form / compose / make up
概	gài * general / approximate
况	kuàng * moreover / situation
钙	gài * calcium
预	yù * to advance / in advance / beforehand
甘	gān * (surname) / sweet / Qinghai province (abbrev.)
竿	gān * pole
肝	gān * liver
秆	gǎn * stalks of grain
染	rǎn * to catch (a disease) / dye
钢	gāng * steel
材	cái * material
琴	qín * (mus. instr.)
纲	gāng * head rope of a fishing net / guiding principle / key link
要	yào * important / vital / to want
杆	gǎn * (measure for guns) / stick / pole
高	gāo * high / tall
烧	shāo * to burn / to cook / to stew
血	xiě * blood
涨	zhǎng * to rise (of prices, rivers)
搞	gǎo * to do / to make / to go in for
鬼	guǐ * ghost / sly / crafty
稿	gǎo * manuscript / draft / stalk of grain
纸	zhǐ * paper
状	zhuàng * accusation / suit / state
歌	gē * song
星	xīng * star / satellite / small amount
格	gé * frame / rule
隔	gé * to separate / to stand or lie between / to divide
离	lí * to leave / to depart / to go away
各	gè * each / every
前	qián * before / in front / ago
界	jiè * boundary / scope / extent
根	gēn * radical (chem.) / root / basis
据	jù * according to / to act in accordance with / to depend on
深	shēn * deep / profound
蒂	dì * stem (of fruit)
固	gù * hard / strong / solid
跟	gēn * to follow / to go with / heel
踪	zōng * footprint / trace / tracks
新	xīn * new / newly / meso- (chem.)
梗	gěng * stem
具	jù * tool / device / utensil
书	shū * book / letter
阶	jiē * rank or step / stairs
读	dú * to read / to study
功	gōng * merit / achievement / result
绩	jī * merit / accomplishment
恭	gōng * respectful
供	gōng * offer (information etc.) / supply
尺	chǐ * a Chinese foot (M) / one-third of a meter / a ruler
平	píng * flat / level / equal
然	rán * correct / right / so
社	shè * society / group
约	yuē * appointment / agreement / to arrange
债	zhài * debt
汞	gǒng * mercury
拱	gǒng * fold hands in salute / to arch
共	gòng * all together / in while / to share
计	jì * to calculate / to compute / to count
勾	gōu * to cancel / to delineate / hook
沟	gōu * ditch / gutter
构	gòu * Broussonetia papyrifera / to construct / to form
想	xiǎng * to think / to believe / to suppose
孤	gū * lone / lonely
姑	gū * paternal aunt
且	qiě * further / moreover
鼓	gǔ * convex / drum / to rouse
古	gǔ * ancient / old
怪	guài * queer / to blame
文	wén * language / culture / writing
骨	gǔ * bone
肉	ròu * meat / flesh
股	gǔ * share / portion / section
份	fèn * (a measure word for gifts, copies of a newspaper) / copy (of newspaper, magazine, etc.) / share
雇	gù * hire
故	gù * happening / instance / reason
宫	gōng * palace
障	zhàng * to block / to hinder / to obstruct
顾	gù * look after / take into consideration / to attend to
虑	lǜ * anxiety
全	quán * all / whole / entire
执	zhí * execute (a plan) / grasp
挂	guà * to hang / to put up / to suspend
钩	gōu * entice / hook
节	jié * festival / section / segment
切	qiē * to cut / to slice
观	guān * to look at / to watch / to observe
赏	shǎng * enjoy the beauty of / give
管	guǎn * to take care (of) / to control / to manage
辖	xiá * have jurisdiction over
惯	guàn * accustomed to / used to
例	lì * example / precedent / rule
语	yǔ * dialect / language / speech
灌	guàn * irrigate / pour
木	mù * tree / wood
亮	liàng * light / bright
硅	guī * silicon
龟	guī * tortoise / turtle
底	dǐ * background / bottom / base
女	nǚ * female / woman
桂	guì * Cinnamonum cassia / Guangxi Autonomous Region (abbrev.)
冠	guān * hat / crown / crest
族	zú * race / nationality / ethnicity
滚	gǔn * to boil / to roll
际	jì * border / edge / boundary
券	quàn * deed / bond / contract
民	mín * the people / nationality / citizen
土	tǔ * earth / dust
果	guǒ * fruit / result
过	guò * (experienced action marker) / to cross / to go over
问	wèn * to ask
海	hǎi * ocean / sea
港	gǎng * harbor / Hong Kong (abbr.)
含	hán * to keep / to contain
寒	hán * cold / poor / to tremble
函	hán * envelope / case / letter
卫	wèi * to guard / to protect / to defend
旱	hàn * drought
灾	zāi * disaster / calamity
汉	hàn * Chinese / name of a dynasty
奸	jiān * traitor / adultery
豪	háo * grand / heroic
好	hǎo * good / well
说	shuō * to speak / to say
样	yàng * manner / pattern / way
在	zài * (located) at / in / exist
转	zhuàn * to revolve / to turn / to circle about
耗	hào * mouse / new / to waste
费	fèi * to cost / to spend / fee
浩	hào * grand / vast (water)
客	kè * customer / visitor / guest
荷	hè * peppermint / to carry burden
核	hé * nuclear / atomic / stone (of fruit)
桃	táo * peach
武	wǔ * martial / military
器	qì * device / tool / utensil
何	hé * carry / what / how
乎	hū * (interrog. part.)
伙	huǒ * assistant / furniture / partner
营	yíng * army / to deal in / to trade
资	zī * resources / capital / to provide
苗	miáo * (surname) / Miao tribe / sprout
河	hé * river
贺	hè * congratulate
黑	hēi * black / dark / Heilongjiang Province (abbrev.)
狠	hěn * ruthless / fierce / severe
恒	héng * permanent
横	héng * horizontal / across / (horizontal character stroke)
轰	hōng * explosion / bang / boom
烈	liè * ardent / intense / split
炸	zhà * explode
烘	hōng * bake / heat by fire
虹	hóng * rainbow
宏	hóng * spacious
领	lǐng * neck / collar / to lead
巾	jīn * towel
哄	hōng * resound with laughter
厚	hòu * generous / thick (for flat things)
候	hòu * wait
勤	qín * diligent / frequent
台	tái * (measure word machines) / platform / stage
呼	hū * to call / to cry / to shout
声	shēng * sound / voice / (a measure word, used for sounds)
忽	hū * suddenly
胡	hú * (surname) / beard / what why how
糊	hú * muddled / paste / scorched
互	hù * mutual
户	hù * a household / door / family
纹	wén * line / trace / mark
丽	lì * beautiful
画	huà * draw / picture / painting
纤	xiān * fine / delicate / minute
话	huà * dialect / language / spoken words
树	shù * tree
怀	huái * to think of / to cherish / mind
欢	huān * joyous / happy / pleased
环	huán * bracelet / ring (not for finger) / to surround
原	yuán * former / original / primary
取	qǔ * to take / to get / to choose
患	huàn * misfortune / suffer (from illness) / trouble
荒	huāng * out of practice / uncultivated
凉	liáng * cool / cold
唐	táng * Tang dynasty (618-907)
慌	huāng * to get panicky / to lose one's head
张	zhāng * (a measure word) / (a surname) / open up
黄	huáng * (surname) / sulfur / yellow
金	jīn * metal / money / gold
皇	huáng * (surname) / emperor
晃	huàng * sway / to shade
挥	huī * scatter / wield / wipe away
霍	huò * (surname) / cholera
击	jī * to hit / to strike / to break
收	shōu * to receive / to accept / to collect
毁	huǐ * to destroy / to damage / to ruin / to defame
灭	miè * extinguish
悔	huǐ * regret
汇	huì * remit / to converge (of rivers) / to exchange
绘	huì * to draw / to paint
混	hùn * to mix / to get along / thoughtless
纺	fǎng * spin
豁	huò * clear / open / exempt (from)
山	shān * mountain / hill
或	huò * maybe / perhaps / might
是	shì * is / are / am
许	xǔ * to allow / to permit / to praise
祸	huò * disaster
基	jī * base / foundation / basic
教	jiāo * teach
灵	líng * alert / departed soul / efficacious
枪	qiāng * gun / firearm / rifle
遇	yù * meet with
积	jī * to amass / to accumulate / to store
激	jī * to arouse / to incite / to excite
励	lì * exhort
吉	jí * lucky / Jilin Province (abbrev.)
普	pǔ * general / popular / everywhere
极	jí * extremely / pole (geography, physics) / utmost
限	xiàn * limit / bound
籍	jí * (surname) / record / register
贯	guàn * pierce / to string
邮	yóu * post (office) / mail
及	jí * to reach / and
早	zǎo * early / morning
急	jí * hurried / worried
需	xū * to require / to need / to want
即	jí * namely / right away / to approach
梁	liáng * (surname) / beam of roof / bridge
几	jǐ * a few / how many
象	xiàng * shape / form / appearance
寄	jì * lodge at / to mail / to send
托	tuō * to hold in one's hand / to entrust / to support in one's palm
寂	jì * lonesome
较	jiào * clear / distinct / compare
记	jì * to remember / to note / mark
忆	yì * remember
忌	jì * avoid as taboo / jealous
继	jì * to continue / to follow after / then
纪	jì * discipline / age / era
嘉	jiā * excellent
奖	jiǎng * prize / award / encouragement
夹	jiā * clip / folder / hold between
杂	zá * mixed / miscellaneous / various
晓	xiǎo * dawn / to know / to tell (sb sth)
颊	jiá * cheeks
甲	jiǎ * "A" (in a sequence of examples involving "A", "B", "C", etc.) / 1st heavenly stem / 1st in order
板	bǎn * board / plank / plate / boss
冒	mào * brave / bold / to cover
设	shè * to set up / to arrange / to establish
驾	jià * to drive / to draw / to harness
监	jiān * hard / strong / solid
察	chá * examine / inquire / observe
坚	jiān * strong / solid / firm
实	shí * real / true / honest
信	xìn * letter / true / to believe
屈	qū * bent / feel wronged
尖	jiān * point (of needle) / sharp / shrewd
兼	jiān * double / twice / simultaneous
任	rèn * to assign / to appoint / office
肩	jiān * shoulder
膀	bǎng * upper arm / wing
艰	jiān * difficult / hard / hardship
茧	jiǎn * cocoon
检	jiǎn * to check / to examine / to inspect
举	jǔ * to lift / to hold up / to cite
修	xiū * to decorate / to embellish / to repair
简	jiǎn * simple
易	yì * (surname) / change / easy
剪	jiǎn * cut with scissors / scissors
彩	cǎi * (bright) color / variety / applause
减	jiǎn * to lower / to decrease / to reduce
间	jiān * between / among / space
接	jiē * to extend / to connect / to receive
鉴	jiàn * example / mirror / to view
践	jiàn * fulfill (a promise) / tread / walk
踏	tà * step on
识	shí * to know / knowledge
键	jiàn * (door lock) key
盘	pán * dish / tray / to build
美	měi * America / beautiful
壮	zhuàng * to strengthen / strong / robust
姜	jiāng * (surname) / ginger
桨	jiǎng * oar / paddle
讲	jiǎng * to talk / speech / to speak
降	jiàng * to drop / to fall / to come down
临	lín * to face / to overlook / to arrive
焦	jiāo * burnt / scorched / worried
炭	tàn * carbon / charcoal
胶	jiāo * glue / gum
片	piàn * a slice / piece / flake
涉	shè * involve / concern / wade
替	tì * to substitute for / to take the place of / to replace
往	wǎng * to go (in a direction) / past / previous
浇	jiāo * to water
娇	jiāo * lovable / pampered / tender
嚼	jué * to chew
搅	jiǎo * to disturb / to annoy / to mix
绞	jiǎo * hang (a criminal) / to turn / to twist
缴	jiǎo * hand in / hand over
条	tiáo * measure word for long, thin things (i.e. ribbon, river, etc.) / a strip / item
叫	jiào * to call / to yell / to be called
喊	hǎn * call / cry / to shout
唤	huàn * to call
嚷	rǎng * blurt out / to shout
揭	jiē * lift off (a cover) / divulge
连	lián * (surname) / even / as
三	sān * three / 3
皆	jiē * all / each and every / in all cases
街	jiē * street
止	zhǐ * to stop / prohibit / till
劫	jié * plunder
杰	jié * hero / heroic
晶	jīng * crystal
散	sàn * adjourn / scatter
戒	jiè * swear off / warn against
严	yán * (air or water) tight / stern / serious
借	jiè * to lend / to borrow / excuse
牌	pái * cards / game pieces / signboard
融	róng * harmonious / melt / mild
筋	jīn * muscle
津	jīn * Tianjin / ferry
紧	jǐn * tight / nervous / strict
缩	suō * to withdraw / to pull back / to contract
锦	jǐn * brocade / embroidered work / bright
绣	xiù * to embroider
尽	jǐn * to the utmost
快	kuài * fast / quick / swift
进	jìn * advance / enter / to come in
展	zhǎn * to use / to spread out / to postpone
晋	jìn * name of a dynasty
升	shēng * to raise / to hoist / to promote
禁	jìn * to prohibit / to forbid
似	sì * to seem / to appear / similar
惊	jīng * to start / to be frightened / to be scared
精	jīng * energy / perfect / excellent
益	yì * benefit / increase
典	diǎn * canon / dictionary
茎	jīng * stalk / stem
警	jǐng * to alert / to warn
景	jǐng * bright / circumstance / scenery
颈	jǐng * neck
悄	qiǎo * quiet / sad
远	yuǎn * far / distant / remote
镜	jìng * mirror
竞	jìng * to compete / to contend / to struggle
净	jìng * clean / completely / only
纠	jiū * gather together / to investigate / to entangle
纷	fēn * numerous / confused / disorderly
玖	jiǔ * (black stone) / nine (fraud-proof)
济	jì * aid / ferry / frugal
就	jiù * at once / then / right away
留	liú * leave (message) / to retain / to stay
束	shù * bunch / (a measure word) / to bind
室	shì * room
势	shì * conditions / influence / tendency
闻	wén * (surname) / hear / sniff at
目	mù * eye / item / section
聚	jù * form gathering / gather
拒	jù * to resist / to repel / to refuse
悉	xī * in all cases / know
锯	jù * a saw / to saw
团	tuán * dumpling
捐	juān * to contribute / to donate / tax
圈	quān * circle / ring / loop
掘	jué * dig
醒	xǐng * to wake up / to awaken / to be awake
赛	sài * to compete / competition / match
望	wàng * hope / expect / to visit
缘	yuán * along / predestined affinity / reason
菌	jùn * bacteria / mold / mushroom
医	yī * medical / medicine / doctor
君	jūn * monarch / lord / gentleman
俊	jùn * smart / eminent / handsome
卡	kǎ * to check / to stop / to block
阔	kuò * rich / wide / broad
朗	lǎng * clear / bright
支	zhī * (a measure word) / to support / to sustain
凯	kǎi * triumphant / victorious
旋	xuán * revolve
刊	kān * to print / publish
探	tàn * to explore / to search out / to scout
糠	kāng * husk
炕	kàng * kang (a heatable brick bed)
磕	kē * to tap / knock
颗	kē * (measure word for small spheres)
粒	lì * a grain / a granule
科	kē * branch of study / administrative section / division
喜	xǐ * to be fond of / to like / to enjoy
课	kè * subject / class / lesson
啃	kěn * to gnaw / to nibble / to bite
恳	kěn * earnest
洞	dòng * cave / hole
虚	xū * devoid of content / void / false
恐	kǒng * afraid / frightened / to fear
惧	jù * to fear
孔	kǒng * (surname) / hole
控	kòng * to accuse / to charge / to control
诉	sù * complain / sue / tell
抠	kōu * dig out (with finger) / stingy
腔	qiāng * cavity of body / tune
枯	kū * dried up
燥	zào * dry / parched / impatient
苦	kǔ * bitter / intensely / miserable
难	nán * difficult (to...) / problem / difficulty
夸	kuā * to boast
挎	kuà * (v) carry on one's arm / (v) carry over one's shoulder or slung on one's side
速	sù * fast / rapid / quick
宽	kuān * lenient / wide / broad
广	guǎng * wide / numerous / to spread
框	kuàng * frame / door frame
矿	kuàng * ore / mine
井	jǐng * warn / well
亏	kuī * deficiency / deficit
损	sǔn * to damage / injure / to lose
困	kùn * distress / sleepy / doze off
扩	kuò * enlarge
腊	là * December / preserved (meat)
月	yuè * moon / month
去	qù * to go / to leave / to remove
历	lì * to experience / to undergo / to pass through
赖	lài * disclaim / rely / to blame
兰	lán * orchid
懒	lǎn * lazy
狼	láng * wolf
漫	màn * free / unrestrained / inundate
牢	láo * firm / fast
老	lǎo * old (of people) / venerable (person)
鼠	shǔ * rat / mouse
太	tài * highest / greatest / too (much)
婆	pó * grandmother / matron / mother-in-law
一	yī * one / 1 / single
辈	bèi * contemporaries / generation / lifetime
涝	lào * flooded
乐	yuè * (surname) / music
勒	lè * rein in
雷	léi * (surname) / thunder
棱	léng * corner / square beam
冷	lěng * cold
犁	lí * plow
休	xiū * to rest
礼	lǐ * gift / propriety / rite
枝	zhī * branch / (a measure word)
厉	lì * severe
米	mǐ * (measure word) meter / rice
桥	qiáo * bridge
青	qīng * green (blue, black) / Qinghai province (abbrev.)
邦	bāng * a state / country or nation
爬	pá * crawl / climb
夜	yè * night
莲	lián * lotus
廉	lián * incorrupt / inexpensive
洁	jié * clean
政	zhèng * political / politics / government
帘	lián * wine shop sign
脸	liǎn * face
盆	pén * basin
恋	liàn * feel attached to / long for / love
两	liǎng * both / two / ounce
晾	liàng * to dry in the air
疗	liáo * to treat / to cure
席	xí * banquet / woven mat / seat
林	lín * woods / forest
磷	lín * phosphorus / water in rocks
邻	lín * neighbor / adjacent / close to
零	líng * remnant / zero
碎	suì * to break down / to break into pieces / fragmentary
玲	líng * (used in compounds) / tinkling of gem-pendants
凌	líng * encroach / soar / thick ice
晨	chén * morning / dawn / daybreak
敏	mǐn * keen
岭	lǐng * mountain range
先	xiān * early / prior / former
酸	suān * sour / sore / ache
露	lù * to show / to reveal / to expos
龙	lóng * dragon / imperial / Long (a surname)
聋	lóng * deaf
隆	lóng * grand / intense / prosperous
漏	lòu * funnel / to leak / to let out
税	shuì * taxes / duties
鹿	lù * deer
录	lù * to record / to hit / to copy
旅	lǚ * trip / travel
履	lǚ * shoe / to tread on
七	qī * seven / 7
八	bā * eight / 8
糟	zāo * to waste / spoil
微	wēi * micro / tiny / miniature
抡	lūn * whirl (one's arm)
论	lùn * by the / per / discuss
罗	luó * (surname) / gauze / to collect
丝	sī * silk / thread / trace
筐	kuāng * basket
抹	mǒ * play / to smear
麻	má * (to have) pins and needles / tingling / hemp
袋	dài * a pouch / bag / sack
醉	zuì * intoxicated
马	mǎ * horse / horse chess piece / Surname
铃	líng * (small) bell
埋	mái * bury
没	méi * (negative prefix for verbs) / have not / not
延	yán * to prolong / to extend / to delay
茫	máng * vague / vast
枚	méi * M for small objects
霉	méi * bacteria / fungi / moldy
吃	chī * eat
穿	chuān * to bore through / pierce / perforate
媒	méi * medium / intermediary / matchmaker
介	jiè * introduce / lie between / between
镁	měi * magnesium
德	dé * Germany / virtue / goodness
妙	miào * clever / wonderful
足	zú * foot / to be sufficient
门	mén * opening / door / gate
芽	yá * bud / sprout
迷	mí * bewilder / crazy about / fan
惑	huò * confuse
弥	mí * full / to fill / overflowing
棉	mián * cotton
免	miǎn * to exempt / to remove / to avoid
俱	jù * a social club / entirely / without exception
描	miáo * depict / to trace (a drawing) / to copy
众	zhòng * multitude
锐	ruì * acute
其	qí * his / her / its
誉	yù * reputation
摸	mō * feel with the hand / to touch / to stroke
索	suǒ * to search / to demand / to ask
模	mó * imitate / model / norm
摩	mó * rub
擦	cā * to wipe / to erase / rubbing (brush stroke in painting)
魔	mó * devil
术	shù * method / technique
莫	mò * do not / there is none who
默	mò * silent / write from memory
谋	móu * to plan / seek / scheme
牧	mù * shepherd
穆	mù * (surname) / solemn
乃	nǎi * to be / thus / so
奶	nǎi * breast / lady / milk
耐	nài * to be unbearable / unable to endure
男	nán * male
内	nèi * inside / inner / internal
阁	gé * council-chamber / shelf
脏	zāng * dirty / filthy
尼	ní * Buddhist nun / (often used in phonetic spellings)
拟	nǐ * plan to
逆	nì * contrary / opposite / backwards
捻	niǎn * twirl (in the fingers)
撵	niǎn * expel
酿	niàng * ferment / brew
尿	suī * urinate / urine
捏	niē * to pinch (with one's fingers) / to knead / to make up
造	zào * to make / to build / to invent
凝	níng * congeal / concentrate attention
肯	kěn * to agree / to consent / to be ready (to do sth)
愿	yuàn * hope / wish / desire
纽	niǔ * to turn / to wrench / button
扣	kòu * 10 percent / button / detain
浓	nóng * concentrated / dense
农	nóng * agriculture
弄	nòng * to do / to manage / to handle
奴	nú * slave
役	yì * service
怒	nù * indignant
吼	hǒu * roar (of a lion)
挪	nuó * to shift / to move
吐	tǔ * to spit
扒	bā * climb / pull (out) / to strip
拍	pāi * to clap / to pat / to beat
挤	jǐ * crowded / to squeeze
派	pài * clique / school / group
遣	qiǎn * dispatch
判	pàn * to judge / to sentence / to discriminate
庞	páng * (surname) / huge / enormous
胖	pàng * fat / plump
抛	pāo * to throw / to toss / to fling
弃	qì * abandon / relinquish / to discard
刨	bào * a plane / to plane / level or make smooth
跑	pǎo * to run / to escape
培	péi * to cultivate / to earth up
训	xùn * example / pattern / to teach
赔	péi * lose in trade / pay damage
偶	ǒu * accidental / image / pair
喷	pēn * to puff / to spout / to spray
坯	pī * unburnt earthenware
劈	pī * hack / chop / split open
疲	pí * weary
乏	fá * short of / tired
皮	pí * leather / skin / fur
屁	pì * to break wind / to fart
偏	piān * one-sided / to lean / to slant
刻	kè * quarter (hour) / (a measure word) / to carve
漂	piāo * to float / to drift
撇	piē * cast away
瞥	piē * blink / glance
拼	pīn * piece together / stake (all) / spell
频	pín * frequency / frequently / repetitious
贫	pín * poor
聘	pìn * betrothed / engage (teacher) / hire
请	qǐng * to ask / to invite / please (do sth)
日	rì * day / sun / date
坦	tǎn * flat / open-hearted / level
整	zhěng * exactly / in good order / whole
逢	féng * every time / meet by chance
评	píng * to discuss / to comment / to criticize
估	gū * estimate
审	shěn * to examine / to investigate / carefully
屏	píng * (standing) screen
颇	pō * quite / rather / uneven
裂	liè * crack / split
使	shǐ * to make / to cause / to enable
扑	pū * to rush at / to throw oneself on
克	kè * gram / subdue / to restrain
糖	táng * sugar / sweets / candy
仆	pú * servant
朴	pǔ * Pak or Park (Korean surname) / plain and simple
谱	pǔ * chart / list / score (music)
曲	qǔ * tune / song
舌	shé * tongue
柒	qī * seven (fraud-proof)
漆	qī * paint / lacquer
沏	qī * to steep (tea)
奇	qí * strange / odd / weird
特	té * special / unusual / extraordinary
旗	qí * banner / flag
码	mǎ * a weight / number / yard
身	shēn * body / torso / person
岂	qǐ * how can it be that
启	qǐ * to open / to start
砌	qì * to build by laying bricks or stones
械	xiè * tools
喘	chuǎn * to gasp / to pant / asthma
汽	qì * steam / vapor
掐	qiā * pick (flowers) / to pinch
恰	qià * exactly / just
如	rú * as (if) / such as
牵	qiān * lead along
扯	chě * pull / tear / to talk casually
引	yǐn * to lead / to divert (water) / to guide
千	qiān * thousand
万	wàn * Wan (surname) / ten thousand / a great number
瓦	wǎ * tile
签	qiān * a note / a stick / sign one's name
署	shǔ * office / bureau
逊	xùn * to yield
提	tí * to carry / to lift / to put forward
潜	qián * hidden / latent / secret
责	zé * duty / responsibility / to reproach
嵌	qiàn * deep valley / inlay
抢	qiǎng * fight over / to rush / to scramble
锹	qiāo * shovel / to dig
乔	qiáo * tall
胞	bāo * the placenta / womb
听	tīng * listen / hear / obey
佩	pèi * to respect / wear (belt, etc.)
侵	qīn * to invade / to infringe / to approach
亲	qīn * dear / intimate / parent
生	shēng * to be born / to give birth / life
友	yǒu * friend
禽	qín * birds / fowl
轻	qīng * light / easy / gentle
氢	qīng * hydrogen
倾	qīng * to overturn / to collapse / to lean
斜	xié * slanting
寺	sì * Buddhist temple
晴	qíng * clear / fine (weather)
庆	qìng * celebrate
秋	qiū * autumn / fall / harvest time
趋	qū * to hasten / to hurry / walk fast
驱	qū * to expel / to urge on / to drive
逐	zhú * to pursue / to chase / individually
威	wēi * power / might / prestige
泉	quán * fountain / spring
犬	quǎn * dog
劝	quàn * to advise / to urge / to try to persuade
阻	zǔ * to hinder / to block / to obstruct
缺	quē * lack / scarce / vacant post
陷	xiàn * to fall / trap
瘸	qué * lame
凿	záo * chisel
群	qún * crowd / flock / group
让	ràng * to ask / to let / permit
扰	rǎo * disturb
泪	lèi * tears
均	jūn * equal / even / all
仁	rén * humane
荣	róng * glory / honored
熔	róng * to smelt / fuse
溶	róng * dissolve
绒	róng * velvet / woolen
柔	róu * soft
乳	rǔ * breast / milk
软	ruǎn * soft / flexible
瑞	ruì * lucky / auspicious / propitious
雪	xuě * snow
撒	sǎ * to scatter
腮	sāi * gills / lower part of cheeks
五	wǔ * five / 5
角	jiǎo * angle / horn / horn-shaped
叁	sān * three (formal form used on checks, etc.)
桑	sāng * mulberry tree
扫	sǎo * to sweep
滩	tān * beach / shoal
砂	shā * sand / gravel / granule
傻	shǎ * foolish
筛	shāi * to filter / to sift / to sieve
陕	shǎn * Shaanxi
脚	jiǎo * foot / base
腰	yāo * waist / lower back / pocket
闪	shǎn * flash / lightning
耀	yào * brilliant / glorious
善	shàn * good
痕	hén * scar / traces
讨	tǎo * ask for / send punitive expedition / to demand
午	wǔ * 11 a.m.-1 p.m. / 7th earthly branch / noon
梢	shāo * tip of branch
捎	shāo * bring or take (along)
饼	bǐng * round flat cake / cookie / cake
少	shǎo * few / little / lack
哨	shào * a whistle / sentry
舍	shè * residence
摄	shè * assist / collect / absorb
施	shī * (surname) / distribute (alms) / to do
伸	shēn * to stretch / to extend
奥	ào * obscure / mysterious
浅	qiǎn * shallow
士	shì * scholar / warrior / knight
仙	xiān * immortal
讯	xùn * to question / to ask / to interrogate
渗	shèn * to seep / to ooze / to horrify
透	tòu * to penetrate / thorough / penetrating
怕	pà * to be afraid / to fear
疏	shū * negligent / sparse / thin
殖	zhí * grow / reproduce
牲	shēng * domestic animal
省	shěng * frugal / save / to omit
误	wù * mistake / error / to miss
湿	shī * moist / wet
诗	shī * poem / poetry / verse
尸	shī * corpse
十	shí * ten / 10
灰	huī * gray / ash
拾	shí * pick up / ten (fraud-proof)
食	shí * animal feed / eat / food
欲	yù * desire / longing / appetite
惠	huì * favor / kind act (from above)
史	shǐ * history
料	liào * material / stuff / grain
屎	shǐ * stool / feces
始	shǐ * begin
侍	shì * attend on
项	xiàng * (surname) / back of neck / item
释	shì * explain / to release
野	yě * field / plain / open space
买	mǎi * buy
筒	tǒng * tube / cylinder
艺	yì * skill / art
首	shǒu * head / chief / first (occasion)
脑	nǎo * brain
守	shǒu * to guard
瘦	shòu * tight / thin / lean
输	shū * to transport / to lose
舒	shū * (surname) / relax
写	xiě * to write
竖	shù * (straight down character stroke) / to erect / vertical
衰	shuāi * weak / feeble / decline
帅	shuài * handsome / graceful / smart
蒸	zhēng * to steam
顺	shùn * to obey / to follow / to arrange
绪	xù * beginnings / clues / mental state
司	sī * company / control
令	lìng * make or cause to be / order / command
死	sǐ * to die / inpassable / uncrossable
刑	xíng * punishment
四	sì * four / 4
饲	sì * to raise / to rear / to feed
耸	sǒng * excite / raise up / to shrug
搜	sōu * to search
苏	sū * (plant) / place name / revive
俗	sú * vulgar
素	sù * plain / element
讼	sòng * litigation
肃	sù * Gansu / respectful
蒜	suàn * garlic
虽	suī * although / even though
岁	suì * year / years old / (a measure word)
穗	suì * ear of grain
己	jǐ * 6th heavenly stem / self
笋	sǔn * bamboo shoot
他	tā * he / him
泰	tài * safe / peaceful / most
阳	yáng * positive (electric.) / sun
贪	tān * greedy
污	wū * dirt / filth
痰	tán * phlegm / spittle
坛	tán * altar
潭	tán * (surname) / deep
叹	tàn * to sigh
逃	táo * to escape / to run away / to flee
陶	táo * (surname) / pleased / pottery
瓷	cí * chinaware / porcelain
藤	téng * rattan / cane
拔	bá * pull up / pull out / select
炼	liàn * refine / smelt
吊	diào * condole with / hang
谅	liàng * forgive
验	yàn * to examine / to test / to check
剃	tì * shave / to weed
久	jiǔ * (long) time / (long) duration of time
堂	táng * (main) hall / large room
填	tián * to fill in
田	tián * (surname) / field / farm
剂	jì * dose
挑	tiāo * carry on a pole / choose
跳	tiào * jump / hop / skip (a grade)
跃	yuè * to jump / to leap
停	tíng * to stop / to halt / to park (a car)
顿	dùn * a time / jerk / stop
挺	tǐng * be straight and stiff / rather (good)
艇	tǐng * small boat
胀	zhàng * dropsical / swollen / to swell
童	tóng * (surname) / boy / child
捅	tǒng * poke through
统	tǒng * to gather / to unite / to unify
偷	tōu * to steal / to pilfer
投	tóu * to throw / to send
掷	zhì * toss
彻	chè * pervade / penetrate / pass through
秃	tū * bald / blunt
凸	tū * (adj) convex; stick out
圆	yuán * circle / round / circular
推	tuī * push / refuse (responsibility) / shove
屯	tún * to station (soldiers) / to store up
拖	tuō * dragging (brush stroke in painting) / to drag along
脱	tuō * to shed / to take off / to escape
妥	tuǒ * secure / sound
协	xié * cooperate / harmonize / to help
挖	wā * to dig / to excavate / to scoop out
宾	bīn * visitor / guest
型	xíng * model
豆	dòu * bean / peas
湾	wān * bay / gulf
玩	wán * curios / antiques / to play
完	wán * to finish / to be over / whole
毕	bì * the whole of / to finish / to complete
晚	wǎn * evening / night / late
汪	wāng * (surname) / expanse of water / ooze
洋	yáng * foreign / ocean
王	wáng * king / Wang (proper name)
亡	wáng * to die / to perish
忘	wàng * to forget / to overlook / to neglect
却	què * but / yet / however
危	wēi * danger / to endanger
违	wéi * to disobey / to violate / to separate
围	wéi * to circle / to surround
棋	qí * chess
唯	wéi * -ism / only / alone
惟	wéi * -ism / only
维	wéi * to preserve / to maintain / to hold together
伪	wěi * false / fake / forged
尾	wěi * tail
凭	píng * lean against / proof / to rely on
雅	yǎ * elegant
窝	wō * nest
卧	wò * to lie / to crouch
乌	wū * a crow / black
云	yún * cloud / (abbr.) for Yunnan / surname
咽	yàn * to swallow
聊	liáo * to chat / to have a chat / to kill time
伍	wǔ * associate with / five / company
厅	tīng * (reception) hall / office
勿	wù * do not
悟	wù * comprehend
吸	xī * to breathe / to suck in / to absorb
熄	xī * (v) extinguish; quench / go out (of fire)
溪	xī * creek
习	xí * to practice / to study / habit
洗	xǐ * to wash / to bathe
系	xì * be / connection / relation
峡	xiá * gorge
窄	zhǎi * narrow
霞	xiá * red clouds
乡	xiāng * country / village
掀	xiān * lift (cover)
鲜	xiān * fresh
弦	xián * bow string / string of mus. instr.
嫌	xián * to dislike / to suspect
贤	xián * worthy (person)
衔	xián * hold in mouth / nominal office
显	xiǎn * prominent / conspicuous
县	xiàn * a district / county
镶	xiāng * to inlay / to embed / ridge
香	xiāng * fragrant / incense / (of food) savory
响	xiǎng * to make a sound / to sound / to ring
享	xiǎng * enjoy
像	xiàng * (look) like / similar (to) / appearance
消	xiāo * consume / news / subside
翼	yì * wing
校	xiào * school
园	yuán * garden
携	xié * to carry / to take along / to bring along
泻	xiè * to flow (out) swiftly / diarrhea
泄	xiè * divulge / leak out
谢	xiè * (surname) / to thank
屑	xiè * crumbs / filings / worth while
锌	xīn * zinc
欣	xīn * happy
郎	láng * (surname) / a youth
娘	niáng * mother / young lady
里	lǐ * inside / interior / half kilometer
疼	téng * (it) hurts / love fondly / ache
眼	yǎn * eye
仰	yǎng * look up
腥	xīng * fishy (smell)
幸	xìng * fortunate / lucky
杏	xìng * apricot
兄	xiōng * elder brother
凶	xiōng * fierce / terrible / ominous
猛	měng * ferocious / suddenly / fierce
胸	xiōng * chest / bosom / heart
涌	yǒng * bubble up / rush forth
雄	xióng * heroic / male
熊	xióng * bear / to scold / to rebuke
嗅	xiù * sense of smell
秀	xiù * handsome / elegant
袖	xiù * sleeve
须	xū * beard / necessary / must
徐	xú * slow / gentle / Xu (a surname)
叙	xù * narrate / abbreviation for Syria
宣	xuān * to declare (publicly) / to announce
悬	xuán * hang / suspend
削	xuē * to reduce / to pare (away) / to cut (down)
穴	xué * hole / cave
熏	xūn * to smoke / scent / fumigate
循	xún * to follow / to adhere to / to abide by
渐	jiàn * gradual / gradually
巡	xún * to patrol / to make one's rounds
逻	luó * logic / patrol
寻	xún * to search / to look for / to seek
抑	yì * to restrain / to restrict / to keep down
崖	yái * precipice
哑	yā * (onomat.)
轧	yà * crush / in the first place
烟	yān * cigarette / tobacco / smoke
卷	juǎn * to roll (up) / to sweep up / to carry on
雾	wù * fog / mist
淹	yān * drown / submerge
沿	yàn * riverside (with -r)
掩	yǎn * cover up / to surprise
饰	shì * adorn / ornaments
唱	chàng * sing / to call loudly / to chant
宴	yàn * feast / repose
杨	yáng * (surname) / poplar
痒	yǎng * to itch / to tickle
邀	yāo * invite to come
妖	yāo * goblin / witch / devil
遥	yáo * distant / remote / far
么	me * (interrog. suff.)
液	yè * liquid / fluid
旦	dàn * dawn / morning / day-break
个	gè * (a measure word) / individual
技	jì * skill
毛	máo * hair / pore / fur
壹	yī * one (alternate form of 一 used on checks)
治	zhì * to rule / to govern / to manage
依	yī * according to / depend on / near to
衣	yī * clothes
遗	yí * to lose / to leave behind
址	zhǐ * location / site
移	yí * to move / to shift / to change
亿	yì * a hundred million / calculate
亦	yì * also
毅	yì * perseverance
译	yì * to translate / to interpret
因	yīn * cause / reason / because
阴	yīn * (of weather) overcast / Yin / feminine
饮	yǐn * drink
注	zhù * to inject / to pour into / to concentrate
诱	yòu * entice / tempt
隐	yǐn * secret / hidden / concealed
瞒	mán * conceal from
英	yīng * (surname) / English / brave
鹰	yīng * eagle / falcon / hawk
迎	yíng * to welcome
赢	yíng * to beat / to win / to profit
硬	yìng * hard / stiff / strong
映	yìng * reflect / shine
拥	yōng * (v) gather round / rush in / crowd
永	yǒng * forever / always / perpetual (ly)
垂	chuí * to hang (down) / droop / dangle
幽	yōu * quiet / secluded
优	yōu * excellent / superior
郁	yù * (surname) / elegant / melancholy
由	yóu * follow / from / it is for...to
铀	yóu * uranium
犹	yóu * as if / still
幼	yòu * young
愚	yú * stupid
渔	yú * fisherman / to fish
伞	sǎn * umbrella / parasol
羽	yǔ * feather
玉	yù * jade
愈	yù * heal / the more...the more / to recover
寓	yù * reside / residence
冤	yuān * injustice / to wrong
曰	yuē * to speak / to say
匀	yún * even / evenly (divided) / uniform
栽	zāi * to force / to stick in / to plant
宰	zǎi * slaughter / butcher / govern
再	zài * again / once more / next in sequence
攒	zǎn * collect / hoard
赞	zàn * to patronize / to support / to praise
葬	zàng * bury (the dead)
遭	zāo * a time / incident / meet by chance
枣	zǎo * jujube
灶	zào * kitchen stove
贼	zéi * thief
怎	zěn * how
添	tiān * to add / to increase / to replenish
援	yuán * to help / to assist / to aid
闸	zhá * gear / watergate
眨	zhǎ * wink
骗	piàn * to cheat / to swindle / to deceive
榨	zhà * salted vegetable / to extract
摘	zhāi * to borrow / to pick (flowers, fruit) / to pluck
寨	zhài * stronghold / stockade
沾	zhān * infected by / moisten / receive favors
斩	zhǎn * behead / chop
站	zhàn * station / to stand / to halt
岗	gǎng * mound / policeman's beat
掌	zhǎng * in charge of / palm of hand
招	zhāo * provoke / to recruit
勃	bó * flourishing / prosperous / suddenly
泽	zé * beneficence / marsh
兆	zhào * omen / million / million million, trillion
折	zhé * tenth (in price) / to break / to fold
这	zhè * this / these
侦	zhēn * to scout / to spy
诊	zhěn * examine or treat medically
震	zhèn * shake / shock / sign in trigram
振	zhèn * rouse
阵	zhèn * disposition of troops / short period / wave
症	zhèng * disease / illness
郑	zhèng * (surname)
撑	chēng * support / prop-up / to pole a boat
柱	zhù * pillar
汁	zhī * juice
植	zhí * to plant
针	zhēn * injection / needle / pin
致	zhì * to send / to devote / to deliver
忠	zhōng * loyal
钟	zhōng * clock / time as measured in hours and minutes / bell
终	zhōng * end / finish
究	jiū * after all / to investigate / to study carefully
肿	zhǒng * swollen
周	zhōu * cycle / week
舟	zhōu * boat
州	zhōu * (United States) state / province / sub-prefecture
洲	zhōu * continent / island
珠	zhū * bead / pearl
诸	zhū * (surname) / all / many
拄	zhǔ * post / prop
著	zhù * to show / to prove / outstanding
铸	zhù * cast metals / to coin (money)
筑	zhú * build / five-string lute
住	zhù * to live / to dwell / to reside
册	cè * book / a measure word for books / booklet
祝	zhù * invoke / pray to / wish
驻	zhù * resident in / stationed in / located at
扎	zhā * to prick / to run or stick (a needle, etc.) into
爪	zhuǎ * claw
拽	zhuāi * throw
专	zhuān * concentrated / specialized
庄	zhuāng * farm / village
卸	xiè * unload / take off
追	zhuī * pursue (a problem) / to chase
赶	gǎn * to catch up / to overtake / to hurry
准	zhǔn * to allow / to grant / to permit / standard
卓	zhuó * (surname) / outstanding
啄	zhuó * to peck
询	xún * inquire
籽	zǐ * seeds
弟	dì * younger brother
孙	sūn * grandson
宗	zōng * school / sect / purpose
旨	zhǐ * imperial decree / purport / aim
总	zǒng * always / to assemble / gather
纵	zòng * even if / release
狗	gǒu * dog
揍	zòu * beat up / break to pieces
挡	dǎng * hinder / resist / obstruct
拦	lán * cut off / hinder
钻	zuàn * an auger / diamond
尊	zūn * to honor
遵	zūn * to observe / to obey / to follow
磨	mó * to sharpen / to delay / hardship
做	zuò * to do / to make / to produce
座	zuò * seat / base / stand
右	yòu * right (-hand)
悼	dào * mourn / lament
芭	bā * a herb / banana
蕾	lěi * bud
颁	bān * promulgate / send out / issue
侣	lǚ * companion
雹	báo * hail
骤	zhòu * sudden / suddenly
卑	bēi * low / base / vulgar
鄙	bǐ * rustic / low / base
驰	chí * run fast / speed / spread
拙	zhuó * awkward / clumsy / dull
崩	bēng * collapse / fall into ruins
涕	tì * nasal mucus / tears
喻	yù * allegory
碧	bì * green jade / bluish green / blue
弊	bì * detriment / fraud / harm
鞭	biān * a whip or lash / to flog / slash or whip
贬	biǎn * to diminish / to demote / reduce or devaluate
辫	biàn * a braid or queue / to plait
彰	zhāng * manifest
淇	qí * name of a river
秉	bǐng * (surname) / to grasp / hold
涛	tāo * big wave
搏	bó * fight / combat / seize
驳	bó * argue / parti-colored / tranship
亢	kàng * overbearing
愧	kuì * ashamed
朽	xiǔ * rotten
刹	shā * to brake (car)
诧	chà * surprised / to wander / to be astonished
阐	chǎn * to express / disclose / enlighten
猖	chāng * mad / wild
敞	chǎng * spacious / uncovered
畅	chàng * smooth / fluent / joyful
嘲	cháo * ridicule / mock
淀	diàn * shallow water / sediment / precipitate
澄	chéng * clear / limpid / clarify
挚	zhì * (surname) / sincere
沛	pèi * copious / abundant
屉	tì * drawer / tier / tray
踌	chóu * pace back and forth / hesitate / waver
躇	chú * hesitate
稠	chóu * dense / crowded / thick
绸	chóu * (light) silk
厨	chú * kitchen
夕	xī * evening
舶	bó * sea-going vessels / ship
炊	chuī * dress food / to steam / to cook food
摧	cuī * break / destroy / devastate
翠	cuì * bluish-green / green jade
磋	cuō * deliberate / to polish
揽	lǎn * monopolize / seize
拇	mǔ * thumb
雁	yàn * wild goose
歹	dǎi * bad / wicked / evil
怠	dài * idle / lazy / negligent
怯	qiè * afraid / rustic
辰	chén * 5th earthly branch / 7-9 a.m.
刃	rèn * edge of blade
叨	dāo * grumble / garrulous
唠	láo * to chatter
窃	qiè * I beg to presume / steal
笛	dí * flute
缔	dì * closely joined / connection / knot
颠	diān * inverted / jolt / top
簸	bǒ * to winnow
缀	zhuì * sew / stitch together / combine
钮	niǔ * (surname) / button
碟	dié * dish / plate
叮	dīng * sting (of mosquito) / to ask
嘱	zhǔ * enjoin
缎	duàn * satin
兑	duì * to cash
堕	duò * degenerate / fall
蛾	é * moth
碳	tàn * carbon
誓	shì * oath / vow / to swear
茄	qié * eggplant
躁	zào * hot-tempered / impatient
馈	kuì * food / make a present
贩	fàn * deal in / trade in / to peddle
畴	chóu * arable fields / cultivated field / class
汛	xùn * high water / sprinkle water
翔	xiáng * soar
匪	fěi * bandit
诽	fěi * slander
谤	bàng * to slander / defame / speak ill of
歧	qí * divergent / side road
筝	zhēng * (mus. instr.)
凰	huáng * phoenix
敷	fū * announce / apply
衍	yǎn * to spread out / to develop / to overflow
辐	fú * spoke of a wheel
俘	fú * prisoner of war
虏	lǔ * take captive
斧	fǔ * hatchet
蔗	zhè * sugar cane
慨	kǎi * generous / sad
杠	gàng * carrying pole / horizontal bar
诫	jiè * commandment / prohibit
咏	yǒng * sing
疙	gē * pimple / wart
瘩	dá * sore / boil / scab
佣	yōng * hire / servant
棺	guān * coffin
僚	liáo * bureaucrat
棍	gùn * stick
芒	máng * Miscanthus sinensis
闺	guī * women's apartment
滤	lǜ * to strain / to filter
滨	bīn * shore / beach / coast
羞	xiū * shy / ashamed / shame
暄	xuān * genial and warm
罕	hǎn * rare
捍	hàn * ward off (a blow)
蔼	ǎi * friendly
睦	mù * friendly
谐	xié * harmonious
禾	hé * cereal / grain
啸	xiào * to hiss / to whistle
吁	yù * implore
葫	hú * Allium scorodoprasum / bottle gourd
芦	lú * rush / reed / Phragmites communis
狐	hú * fox
狸	lí * (dog) / wild cat
妆	zhuāng * adornment / adorn
槐	huái * Sophora japonica
孕	yùn * pregnant
谬	miù * absurd / erroneous
蝗	huáng * locust
贿	huì * bribe / bribery
赂	lù * bribe / bribery
晤	wù * meet (socially)
浊	zhuó * impure / muddy
讥	jī * ridicule
嫉	jí * jealousy / be jealous of
妒	dù * jealous
脊	jǐ * spine / back / ridge
畜	chù * livestock / domesticated animal / domestic animal
韧	rèn * annealed / pliable but strong / tough
贞	zhēn * chaste
陋	lòu * low / humble / plain
唆	suō * incite / suck
轿	jiào * sedan chair
洽	qià * accord / make contact
坊	fāng * subdivision of a city
兢	jīng * to be fearful / apprehensive
鞠	jū * to bring up / to rear / Ju (a surname)
躬	gōng * body / oneself / personally
拘	jū * adhere / capture / restrain
菊	jú * chrysanthemum
瞩	zhǔ * to gaze at / to stare at
赠	zèng * give present
阀	fá * clique / valve
垦	kěn * reclaim (land)
拓	tuò * expand / support on palm / to develop
勘	kān * to investigate / to survey / to collate
慷	kāng * generous / magnanimous
泣	qì * to sob
雀	què * bird
隙	xì * crack / occasion for dislike
妄	wàng * absurd / fantastic
旷	kuàng * waste / wilderness
葵	kuí * sunflower
蜡	là * candle / wax
烛	zhú * candle
栏	lán * fence / railing / hurdle
惰	duò * lazy
狈	bèi * a legendary wolf / distressed / wretched
篱	lí * a fence
笆	bā * an article made of bamboo strips / fence
睬	cǎi * pay attention / take notice of / to care for
荔	lì * litchi
栗	lì * (surname) / chestnut
沥	lì * drip
绵	mián * cotton / incessant / soft
镰	lián * scythe / sickle
链	liàn * chain / lead or tin ore
辽	liáo * Liaoning / name of a dynasty
潦	lǎo * flooded / heavy rain
珑	lóng * tinkling of gem-pendants
伶	líng * clever
俐	lì * clever
硫	liú * sulfur
寇	kòu * bandit
屡	lǚ * time and again
螺	luó * screw / snail
骡	luó * mule
箩	luó * basket
痹	bì * numb / paralysis
蚂	mǎ * ant
蚁	yǐ * ant
薯	shǔ * potato / yam
蔓	màn * creeper / to spread
盲	máng * blind
碌	lù * laborious / small stone / to record
茂	mào * luxuriant
玫	méi * rose
瑰	guī * (semi-precious stone) / extraordinary
辙	chè * to remove / to withdraw
萌	méng * people / sprout
勉	miǎn * exhort
渺	miǎo * vague / remote
蔑	miè * belittle / nothing
蘑	mó * mushroom
菇	gū * mushroom
匠	jiàng * craftsman
睹	dǔ * observe / see
柠	níng * lemon
檬	méng * lemon
殴	ōu * brawl
呕	ǒu * vomit
徘	pái * irresolute
徊	huái * irresolute / move back and forth
沫	mò * foam / suds
烹	pēng * cuisine / cooking
饪	rèn * cooked food / cook until well done
惫	bèi * exhausted
僻	pì * low / rustic / secluded
萍	píng * duckweed
葡	pú * grapes
萄	táo * grapes
瀑	pù * waterfall
凄	qī * intense cold / mournful
乞	qǐ * beg
魄	pò * soul
谦	qiān * modest
钳	qián * pincers / pliers / tongs
谴	qiǎn * punishment / scold
毙	bì * die violently
侨	qiáo * emigrant / reside abroad
钦	qīn * royal
蚀	shí * eat up slowly / eclipse
俭	jiǎn * frugal / to be in need
芹	qín * Chinese celery
蜻	qīng * dragonfly
蜓	tíng * dragonfly
柬	jiǎn * card / note / letter
帖	tiě * invitation card / notice
盈	yíng * full / filled / surplus
眶	kuàng * eye socket
痴	chī * imbecile / sentimental / stupid
谎	huǎng * lies / to lie
珊	shān * coral
瑚	hú * coral
冈	gāng * ridge / mound
擅	shàn * usurp / without authority
晌	shǎng * around noon
奢	shē * extravagant
侈	chǐ * extravagant / wasteful / exaggerating
呻	shēn * groan
吟	yín * moan / to hum
绅	shēn * member of gentry
肾	shèn * kidney
髦	máo * bang (hair) / fashionable / mane
榴	liú * pomegranate
爽	shuǎng * invigorating / straightforward / frank
肢	zhī * limb
隧	suì * subterranean / underground passage
瘫	tān * paralyzed
痪	huàn * illness / numbness of the limbs
滔	tāo * overflow / torrent-dash
淘	táo * cleanse / eliminate / to clean out
汰	tài * to discard / to eliminate / too
衅	xìn * offer blood in sacrifice
泊	bó * to anchor / touch at / to moor
滞	zhì * sluggish
膨	péng * swollen
屠	tú * slaughter / slaughter man
椭	tuǒ * ellipse
唾	tuò * saliva / spit at
豌	wān * peas
惋	wǎn * regret, be sorry / alarmed
桅	wéi * mast
瘟	wēn * epidemic / pestilence / plague
囊	náng * sack
鸦	yā * crow
巫	wū * witch
诬	wū * accuse falsely
呜	wū * (onomat. for humming)
耻	chǐ * shame / disgrace
梧	wú * Sterculia platanifolia
桐	tóng * Aleurites cordata
膝	xī * knee
鹊	què * magpie
涤	dí * wash / cleanse
狭	xiá * narrow / narrow-minded
隘	ài * a pass or defile / narrow / confined
馅	xiàn * stuffing / forcemeat
橡	xiàng * oak / Quercus serrata
徽	huī * insignia
肖	xiào * similar / resembling / to resemble
孝	xiào * filial
挟	xié * clasp under the arm / coerce
颖	yǐng * clever / gifted
薪	xīn * fuel / salary
旺	wàng * prosperous / flourishing / to prosper
膛	táng * chest (of body) / hollow space / throat
汹	xiōng * torrential rush / tumultuous
酗	xù * drunk
絮	xù * line with cotton wadding
靴	xuē * boots
韵	yùn * rhyme
峻	jùn * steep
蛮	mán * barbarian / bullying / very
冶	yě * smelt
裳	cháng * lower garment / skirts / petticoats
淫	yín * excessive / wanton / lewd
秽	huì * dirt / filth
蔽	bì * to cover / to shield / to screen
樱	yīng * cherry
蝇	yíng * fly / musca
庸	yōng * ordinary / to use
昧	mèi * conceal / dark
舆	yú * carriage / sedan chair / world
榆	yú * elm
蕴	yùn * bring together / collect
酝	yùn * to brew
殃	yāng * calamity
蹋	tà * step on
噪	zào * disturbance / noise of crowd
诈	zhà * crafty / dishonest
瞻	zhān * gaze / view
蓬	péng * (grass) / disheveled
暮	mù * evening / sunset
沼	zhǎo * pond / pool
芝	zhī * Zoysia pungens
蜘	zhī * spider
蛛	zhū * spider
脂	zhī * fat
肪	fáng * animal fat
侄	zhí * nephew
瘤	liú * tumor
昼	zhòu * daytime
翁	wēng * (surname) / elderly person
酌	zhuó * consider / pour wine
咨	zī * consult
棕	zōng * palm
挠	náo * to scratch
琢	zhuó * to cut (gems)
铭	míng * inscribed motto
